93  94  110 110 110 110 110 110 93  94  93  94  110 110 93  94  93  94  93  94  93  94  93  94  93  94  93  94  93  94  110 110
101 102 110 110 110 110 110 110 101 102 101 102 110 110 101 102 101 102 101 102 101 102 101 102 101 102 101 102 101 102 110 110
93  94  0   73  74  75  0   0   0   0   0   0   93  94  0   0   0   93  94  0   0   73  74  75  0   0   0   0   0   0   110 110 
101 102 0   81  82  83  0   0   0   0   0   0   101 102 0   0   0   101 102 0   0   81  82  83  0   0   0   0   0   93  94  0  
0   0   0   89  90  91  0   0   0   0   0   0   0   0   0   0   0   0   0   0   0   89  90  91  0   0   110 110 110 101 102 0   
0   0   96  97  106 99  100 111 0   0   0   0   0   0   0   0   0   0   0   111 96  97  106 99  100 111 110 110 110 0   0   0 
93  94  104 105 0   107 108 111 0   0   0   0   0   0   0   0   0   0   0   111 104 105 0   107 108 111 0   0   0   110 110 110
101 102 0   0   0   0   0   0   0   0   0   0   0   0   0   0   0   0   0   0   0   0   0   0   0   0   0   0   0   110 110 110
93  94  0   0   0   0   0   0   0   2   2   2   2   2   2   2   2   2   2   0   0   0   0   0   0   0   0   0   0   110 110 110
101 102 0   0   0   0   0   0   2   2   2   2   2   2   2   2   2   2   2   2   0   0   0   0   0   0   0   0   0   110 110 110
93  94  0   0   0   0   0   2   2   2   2   2   2   2   2   2   2   2   2   2   2   0   0   0   0   0   0   0   0   110 110 110
101 102 0   0   0   0   0   2   2   2   2   2   2   112 2   2   2   2   2   2   2   0   0   0   0   0   0   0   0   110  93  94
93  94  0   0   0   0   0   2   2   2   2   2   2   2   2   2   2   2   2   2   2   0   0   0   0   0   0   0   0   110 101 102
101 102 0   0   0   0   0   2   2   2   2   2   2   2   2   2   2   2   2   2   2   0   0   0   0   0   0   0   0   110  93  94
93  94  0   0   0   0   0   0   2   2   2   2   2   2   2   2   2   2   2   2   0   73  74  75  0   0   0   0   0   110 101 102
101 102 0   0   0   0   0   0   0   2   2   2   2   2   2   2   2   2   2   0   0   81  82  83  0   0   0   0   0   110 110 0
93  94  0   0   0   0   0   0   0   0   0   0   0   0   0   0   0   0   0   0   0   89  90  91  0   0   0   0   0   110 110 0
101 102 0   0   0   0   0   111 0   0   0   0   0   0   0   0   0   0   0   111 96  97  106 99  100 111 0   0   0   110 110 0
93  94  0   0   0   0   0   111 111 111 111 111 111 111 111 111 0   0   0   111 104 105 0   107 108 111 0   0   0   110 110 0
101 102 0   0   0   0   0   0   16  16  16  16  16  16  16  16  0   0   0   0   0   0   0   0   0   0   0   0   0   110 110 0
93  94  0   0   0   0   0   0   16  16  16  16  16  16  16  16  0   0   0   0   0   0   0   0   0   0   0   0   0   110 110 0
101 102 0   0   0   0   0   0   16  16  16  16  16  16  16  16  0   0   0   0   0   0   0   0   0   0   0   0   0   110 110 0
93  94  0   0   0   0   0   0   16  16  16  16  16  16  16  16  0   0   0   0   0   0   0   0   0   0   0   0   0   110 110 0
101 102 0   0   0   0   0   0   16  16  16  16  16  16  16  16  0   0   0   0   0   0   0   0   0   0   0   0   0   110 110 0
93  94  0   0   0   93  94  93  94  0   0   0   0   16  0   0   93  94  0   0   0   0   0   0   0   0   0   0   0   110  93 94
101 102 110 110 110 101 102 101 102 110 110 110 110 16  110 110 101 102 110 110 110 110 110 110 110 110 110 110 110 110 101 0