203 203 203 203 203 203 203 203 203 203 203 203 203 188 184 185 186 188 203 203 203 203 203 203 203 203 203 203 203 203 203 203
203 203 203 203 203 203 203 203 203 203 203 203 203 188 192 193 194 188 203 203 203 203 203 203 203 203 203 203 203 203 203 203
203 11  11  11  11  11  11  11  11  11  11  205 11  196 200 201 202 196 11  11  11  11  11  11  11  11  11  11  11  11  11  203
203 11  11  11  11  11  11  11  11  11  11  205 11  11  11  197 11  11  11  11  11  11  11  205 11  11  11  11  11  11  11  203
203 11  11  11  11  11  11  11  11  11  11  205 11  11  11  11  11  11  11  11  11  11  11  205 11  11  11  11  11  11  11  203
203 205 205 205 197 205 205 205 205 205 197 205 205 205 205 205 205 205 205 205 205 205 205 205 197 205 205 205 205 205 205 205
203 11  11  11  11  11  11  11  205 11  11  11  11  11  11  11  11  11  11  11  11  11  11  205 11  11  11  11  11  11  11  203
203 11  11  11  11  11  11  11  205 11  11  11  11  11  11  11  11  11  11  11  11  11  11  205 11  11  11  11  11  11  11  203
203 205 205 205 197 205 205 205 205 205 205 205 205 205 205 205 205 205 205 11  11  11  11  205 205 205 205 205 205 205 197 205
203 11  11  11  11  11  11  11  11  11  205 11  11  11  11  11  11  11  11  11  11  11  11  205 11  11  11  11  11  11  11  203
203 11  11  11  11  11  11  11  11  11  205 11  11  11  11  11  11  11  11  11  11  11  11  11  11  11  11  11  11  11  11  203
203 205 205 205 197 205 205 205 205 205 205 205 205 205 205 205 205 205 205 205 205 205 205 205 205 205 205 205 205 205 205 205
203 11  11  11  11  205 11  11  11  11  11  11  11  11  205 205 205 11  11  11  11  11  11  11  11  11  11  11  11  11  11  203
203 11  11  11  11  205 11  11  11  11  11  11  11  11  205 205 205 11  11  11  11  11  11  11  11  11  11  11  11  11  11  203
203 197 205 205 205 205 205 205 205 205 205 197 205 205 205 205 205 205 197 205 205 205 205 205 205 205 205 205 205 11  11  205
203 11  11  11  11  11  11  205 205 205 11  11  11  11  205 205 205 11  11  11  11  11  11  205 11  11  11  11  11  11  11  203
203 11  11  11  11  11  11  11  11  11  11  11  11  11  205 205 205 11  11  11  11  11  11  205 11  11  11  11  11  11  11  203
203 11  11  11  11  11  11  11  11  11  11  11  11  11  11  11  11  11  11  11  11  11  11  205 11  11  11  11  11  11  11  203
203 205 205 205 205 205 205 205 205 205 205 205 205 205 205 205 205 205 205 205 205 205 205 205 205 205 197 197 205 205 205 205 
203 11  11  11  11  11  11  11  11  11  11  11  11  11  11  11  11  11  11  11  11  11  11  11  11  11  11  11  11  11  11  203
203 11  11  187 11  187 11  11  11  11  11  11  11  11  11  11  11  11  11  11  11  11  11  11  11  11  11  11  11  11  11  203
203 205 205 205 197 205 205 205 205 205 205 205 205 205 205 205 205 205 205 205 205 205 205 205 205 205 205 205 205 205 205 205 
203 11  11  11  11  11  11  11  11  11  11  11  11  11  11  11  11  11  11  11  11  11  11  11  11  11  11  11  11  11  11  203
203 11  11  11  11  11  11  11  11  11  11  11  11  11  11  11  11  11  11  11  11  11  11  11  11  11  11  11  11  11  11  203
203 203 203 203 203 203 203 203 203 203 203 203 188 188 184 185 186 188 188 203 203 203 203 203 203 203 203 203 203 203 203 203
203 203 203 203 203 203 203 203 203 203 203 203 203 188 192 193 194 188 203 203 203 203 203 203 203 203 203 203 203 203 203 203